11111111111111111111111111111
1E0000000000000C00000C0000001
10100101001000001010010010101
10100100101010100010010010101
1P0000000C00C00000000000000C1
100000000000000C00000C0000001
10100101001000001010010010101
10100100101010100010010010101
100000000C00C00000000000000C1
100000000000000C00000C0000001
10100101001000001010010010101
10100100101010100010010010101
100000000C00C00000000000000C1
100000000000000C00000C0000001
10100101001000001010010010101
10100100101010100010010010101
100000000C00C00000000000000C1
11111111111111111111111111111